......................................................................................................................................................................................................................................................................................................................................................................................................................................................................................................................................................................................................................................................................................................................................................................................................................................................................................................................................................................................................................................#,,
......................................................................................................................................................................................................................................................................................................................................................................................................................................................................................................................................................................................................................................................................................................................................................................................................................................................................................................................................................................................................................................#
......................................................................................................................................................................................................................................................................................................................................................................................................................................................................................................................................................................................................................................................................................................................................................................................................................................................................................................................................................................................................................................#
......................................................................................................................................................................................................................................................................................................................................................................................................................................................................................................................................................................................................................................................................................................................................................................................................................................................................................................................................................................................................................................#
......................................................................................................................................................................................................................................................................................................................................................................................................................................................................................................................................................................................................................................................................................................................................................................................................................................................................................................................................................................................................................................#
.......................................................................................................................................................................................................................................................................................................................................................................................................................................................................................................................................................................................................................................................................................................................................................................................................................................................<------------>.................................................................................................................................................................#
.......................................................................................................................<------->....................................................................................................................................................................................................................................................................................................................................................................................................................................................................................................................................................................................................................................................................................................<------------>....................................................................................................................................................................................#
............................................................................................................<------->.................................<------->.....<------->.......<------------------------------->..........................................................................................................................................................................................................................................................................................................<------------------>....................................................................................................................................................................................................................................................<-------->.....................................................................................................................................................................................................................#
.................................................................................................<------->...............................<------->.......................................................................................................................................................................................................................................................................................................................................................................................................................................................................................................................................................................................................................................<-------->..................<---------->.....................................................................................................................................................................................................#
......................................................................................<------->.........................................................................................................................................................................................................................................................................................................................................................................................................<------------------>..........................<------>.........................................................................................................................................................................................................<------------>.................................................................................................................................................................................................................................................#
...........................................................................<------->............................................................................................................................................................................................<----->.............................................................................................................................................................................................................................................................................................................................................................................................................................................................<------------>.........................................................................................................................................................................<---------->...............................................................................#
................................................................<------->..............................................................................................................................................................................................<------->.................................................................................................................................................................................................<------------------>..........................................................................................................................................................................................................................<------------>............................................................................................................................<------------------->.........................<---------->...................................................................................................#
.....................................................<------->................................................................................................................................................................<---------->....................<----->.............................................................................................................................................................................................................................................................................................<--------------->..................................................................................................................................................................................................................................................................................................................<---------->...........................................<---------->......<---------->............................................#
..........................................<------->...........................................................................................................................................................................................<---------->..................................<------------------->.....................<------------>......................................................................................................<------------------>...................................................................................................................................................<------------>........<--------->........<------------>......................<------------>..........................................................................................................................................................................................................................................................................................................#
...............................<------->......................................................................................................................................................................................................................................................................................................................................<------------>...........................................................................................................................................................................................<--------------->.......<------------>.........................................................................................................................................................................................................................................................................................................................................................................................................#
-----------------------------.........................................................................................................................................................................................................................................................................................<------------>.....................<------------>................................<------------>.............<------------------>......................................................................................................................................................................................................................................<------------>..........................................................................................................................................................................................................................................................................................----------------------------------#
